EJ8a	EastJurong	EJ
JP	EastJurong	EJ
JR	EastJurong	EJ
MRS	EastJurong	EJ
OCAL	EastJurong	EJ
OCHV	EastJurong	EJ
OGTX	EastJurong	EJ
OSP	EastJurong	EJ
OSPJ	EastJurong	EJ
OSPS	EastJurong	EJ
OSPSW	EastJurong	EJ
OSR	EastJurong	EJ
OTK	EastJurong	EJ
OVPJ	EastJurong	EJ
PPT	EastJurong	EJ
RJ	EastJurong	EJ
RP	EastJurong	EJ
TDMAR	EastJurong	EJ
TPUBN	EastJurong	EJ
TPUS	EastJurong	EJ
TSER	EastJurong	EJ
WC	EastJurong	EJ
WFP	EastJurong	EJ
WJFP	EastJurong	EJ
WP	EastJurong	EJ
OJPT	EastJurong	EJ
PulauMerlimau	EastJurong	EJ
Singapore	EastJurong	EJ
MarineLogisticsSMLogShipyard	EastJurong	EJ
BeeSinShipyard	EastJurong	EJ
YTCShipyard	EastJurong	EJ
KimHengOffshoreMarineShipyard	EastJurong	EJ
PenjuruTerminals	EastJurong	EJ
PulauSeraya	EastJurong	EJ
PPLShipyard	EastJurong	EJ
ASLMarineShipyard	EastJurong	EJ
EastShipyard	EastJurong	EJ
PacificRadianceShipyard	EastJurong	EJ
AZMarineShipyard	EastJurong	EJ
BBN	WestJurong	WJ
BGU	WestJurong	WJ
BNT	WestJurong	WJ
BSS	WestJurong	WJ
BST	WestJurong	WJ
BTSF	WestJurong	WJ
OE	WestJurong	WJ
OEJT	WestJurong	WJ
OESHP	WestJurong	WJ
OM	WestJurong	WJ
OMLUB	WestJurong	WJ
PUD	WestJurong	WJ
Pesek8	WestJurong	WJ
STG	WestJurong	WJ
TANAK	WestJurong	WJ
TBUAN	WestJurong	WJ
TJTK	WestJurong	WJ
TMUC	WestJurong	WJ
TPSK1	WestJurong	WJ
WJ10	WestJurong	WJ
WJ9a	WestJurong	WJ
WJ9b	WestJurong	WJ
WJ9cd	WestJurong	WJ
YA	WestJurong	WJ
YFADK	WestJurong	WJ
YFFP	WestJurong	WJ
YFQ	WestJurong	WJ
YH	WestJurong	WJ
YJ	WestJurong	WJ
YJDK	WestJurong	WJ
YJEQ	WestJurong	WJ
YSFD	WestJurong	WJ
YSNQ	WestJurong	WJ
YSSQ	WestJurong	WJ
YSWQ	WestJurong	WJ
YT	WestJurong	WJ
JPSP	WestJurong	WJ
TuasPowerStation	WestJurong	WJ
KeppelShipyards	WestJurong	WJ
AsiaPacificShipyard	WestJurong	WJ
STEngineeringShipyard	WestJurong	WJ
StrategicMarineShipyard	WestJurong	WJ
PulauPesek	WestJurong	WJ
ExxonMobilTerminal	WestJurong	WJ
PulauAyerChawan	WestJurong	WJ
SembcorpMarineJurongShipyard	WestJurong	WJ
JRP	WestJurong	WJ
OECWJ	WestJurong	WJ
